0000010000000000000000
0000010000000000000000
0000010000000000000000
0000010000000000000000
0002_400000002________
0001000000000100000000
0001000000000100000000
0001000000000100000000
0001000000000100000000
0003_________400000000
0000000000000000000000